20 15
####################
#....#........#....#
#....#........#....#
#....#........#....#
#....####..####....#
#..................#
#..................#
#..................#
#..................#
#..................#
#..................#
#........######....#
#........#.>..#....#
#........#....+....#
####################
