30 15
   #########      ##########  
   #.......#      #........#  
####+#####.########........#  
#......# #.................#  
#......# #.########........#  
#......# #.#      #........#  
#......# #.#      ##########  
######## #.#                  
         #.#        ######    
 ####### #.#      ###....###  
 #.....# #.########........## 
 #.....# #.......+..........# 
 #.....###.########........## 
 #.........#      ###....###  
 ###########        ######    
