30 15
##############################
#............................#
#....####################....#
#....#..................#....#
#....#...############...#....#
#....#...#..........#........#
#....#.......#####..#........#
#....#.......#.t....#........#
#....#.......#####..#........#
#....#...#..........#........#
#....#...############...#....#
#....#..................#....#
#....####################....#
#............................#
##############################
